*********G************************************
*       *                                    *
* ****************************************** *
* *            *                             *
* ****** *********************************** *
*              *                             *
* ****** ****************** ******************
* *                         *                *
* ************************* ******************
* *       *         *                        *
* ******* ********* **************************
*                                            *
****** ******* ****** ********************* **
*            *      *                     *
*************************S********************